111111111111111111111111111111111111111111111111111111111111
100000000000000000000000000000000000000000000000000000000001
100000000000000000000000000000000000000000000000000000000001
100000000000000000000000000000000000000000000000000000000001
100000000000000000000000000000000000000000000000000000000001
100000000000000000000000000000000000000000000000000000000001
100C00000000000000000000000000000000000000000000000000000001
100000000000000000000000000000000000000000000000000000000001
100000000000000000000000111110000000000000000000000000000001
100000000000000000000000000000000000000000000000000000000001
1000000000000000000000C0000000000000000000000000000000000001
100000000000000000000000000000000000000000000000000000000001
100000000011111111111111111110000000000000000000000000000001
100000000000000000000000000010000000000000000000000000000001
100000000000000000000000000010000000000000000000000000000001
100000000000000000000000000111111100000000000000000000P00001
100000000000000000000000000000000000000000000000000000000001
100000000000000000000C00000000000000000000000000000000000001
100000000000000000000000000000000000000000000000000000000001
100000000000000000000000000000000000000000000000000000000001
100000000000000000000000111111111111100000000000000000000001
100000000000000000000000000001000000000000000000000000000001
100000000000000000000000000001000000000000000000000000000001
100000000000000000000000000001000000000000000000000000000001
100000000000000000000000000001000000000000000000000000E00001
111111111100000000000000000000000000000000000000000000000001
100000000000000000000C00000000000000000000000000000000000001
100000000000000000000000000000000000000000000000000000000001
100000000000000000000000000000000000000000000000000000000001
100000000000000000000000000000000000000000000000000000C00001
100000000000000000000000000000000000000000000000000000000001
100000000000000000000000000001000000000000000000000000000001
100000000000000000000000000001000000000000000000000000000001
100000000000000000000000000001000000000000000000000000000001
100000000000000000000000000000000000000000000000000000C00001
111111111111111111111111111111111111111111111111111111111111
