

111111111111111111111111111111111111
10000C000000000000000000000000000001
10000000000E000000000000000000000001
10000P000000000000000000000000000001
10000000C000000 00000000000000000001
100000000000000001110000000000000001
100000000000000001010000000000000001
100000000000000001110000000000000001
100000000000000000000000000000000001
100000000000000000000000000000000001
111111111111111111111111111111111111
