111111111111111111111111111111111111
10000C000010000000000000000000000001
10000000001E000000000000000000000001
100000000010000000000000000000000001
10000000C000000000000000000000000001
100000000000000001110000000000000001
100000000000000001010000000000000001
100000000000000001110000000000000001
100000000000000000000000000000000001
100000000000000000000000000000000001
111111111111111111111111111111111111
