
11111111111
10000C00001
10000000001
10000P00001
10000000C01
10000000001
10000000001
10000000001
100000E0001
10000000001
11111111111


