111111111111111111111111111111111111
10001C100000000000000000000000000001
10001110000E000000000000000000000001
10000P011100000000000000000000000001
10000001C100000000000000000000000001
100000011100000001110000000000000001
100000000000000001010000000000000001
100000000000000001110000000000000001
100000000000000000000000000000000001
100000000000000000000000000000000001
111111111111111111111111111111111111
